9 14
|------------|
|.B..........|
|.--.-..|..-.|
|..--...|..-.|
|......-|.@..|
|...--.....-.|
|.....f....-.|
|..F.....B...|
|------------|